 R R R R R R R R R R R R R R R R R R R R R R R R R R R R R R
 G*w w w w w w w w w w w w w w w w w w w w w w w G w w w w w
 G w w w w w w w w w w w w w w w w w w w w w w w G w w w w w
 G G G G G G G G G G G G G G G G G G G w w w w w G w w w w w
 G w w w w w w w w w w w w w w w w w w w w w w w G w w w w w
 G w w w w w w w w w w w w w w w w w w w w w w w G w w w w w
 G G w w w w w w w w w w w w w w w w w w w w w w G w w w w w
 G w w w w w w w w w w w w w w w w w w w w w w w G w w w w w
 G w w w w w w w w w w w w w w w w w w G G G G G G w w w w w
 G w w w w w w w w w w w w w w G G G G w w w w w w w w w w w
 G w w w w w w G G G G w G G G w w w w w w w w w w w w w w w
 G w w w w w w w w w w w w w G w w w w w w w w w w w w w w w
 G w w w w w w w w w w w w w G w w w w w w w w w w w w w w n
 G w w w w w w w w w w w wXn G w w w w w w w w w w w w w n n
 G w G G G G w w w w G G G G G w w w w w w w w w w n w w n n
 G w w w w w w w w w w w w w G w w w w w w w w w w n w n n n
 G+u w w w w w w w w w w w w G w w w w w w w w w w n n n n n
 G f w w w w w w w w w w w w G w w w w n w w w n w n n n n n
 G G G G G G G G G G G G G G G G G G G G G G G G G G G G G G
 G G G G G G G G G G G G G G G G G G G G G G G G G G G G G G
