 R R R R R R R R R R R R R R R R R R R R R R R R R R R R R R
 G w w w w w w w w w w w w w w w w w w w w w w w w w w w w w
 G w w w w w w w w w w w w w w w w w w w w w w w w w w w w w
 G w w w w w w w w w w w w w w w w w w w w w w w w w w w w w
 G w w*w w w w w w w w w w w w w w w w w w w w w w w w w w w
 G w w w w wXn w w w w w w w w w w w w w w w w w w w w w w w
 G w w G G G G G w w w w w w w w w w w w w w w w w w w w w w
 G w w w w w w w w w w w w w w w w w w w w w w w w w w w w w
 G w w w w w w w w w w w w w w w w w w w w w w w w w w w w w
 G w w w w w w w w w w w w w w w w w w w w w w w w w w w w w
 G w w w w w w w w w w w w w w w w w w w w w w w w w w w w w
 G w w w w w w w w w w w w w w w w w w w w w w w w w w w w w
 G w w w w w w w w w w w w w w w w w w w w w w w w w w w w w
 G w w w w w w w w w w w w w w w w w w w w w w w w w w w w w
 G w w w w w w w w w w w w w w w w w w w w w w w w w w w w w
 G w w w w w w w w w w w w w w w w w w w w w w w w w w w w w
 G w w w w w w w w w w w w w w w w w w w w w w w w w w+u w w
 G w w wXn w w w w w w w w w w w w w w w w w w w wXn w f w w
 G G G G G G G G G G G G G G G G G G G G G G G G G G G G G G
 G G G G G G G G G G G G G G G G G G G G G G G G G G G G G G
