 R R R R R R R R R R R R R R R R R R R R R R R R R R R R R R
 G w w w w w w w w w w w w w w w w w w w w w w w w w w w w G
 G w w w w w w w w w w w w w*w w w w w w w w w w w w w w w G
 G w w w w w w w w w w w w w w w w w w w w w w w w w w w w G
 G w w w w w w w w w w w G G G G G w w w w w w w w w w w w G
 G w w w w w w w w w w w w w w w w w w w w w w w w w w w w G
 G w w w w w w w w w w w w w w w w w w w w w w w w w w w w G
 G w w w w w w G w w w w w w w w w w w w w G w w w w w w w G
 G w w w w w wXn G G G G G w w w G G G G GXn w w w w w w w G
 G w w w w w w w w w w w w w w w w w w w w w w w w w w w w G
 G w G w w w w w w w w w w w w w w w w w w w w w w w G w w G
 G wXn G w w w w w w w w w w w w w w w w w w w w w GXn w w G
 G w wXn w G G G G G G G G G w G G G G G G G G G wXn w w w G
 G w w w w w w w w w w w w w+u w w w w w w w w w w w w w w G
 G w w w w w w w w w w w w w f w w w w w w w w w w w w w w G
 G w w w w w w w w w w w w w G w w w w w w w w w w w w w w G
 G w w w w w w w w w w w w w w w w w w w w w w w w w w w w G
 G w w w w w w w w w w w w w w w w w w w w w w w w w w w w G
 G w w w w w w w w w w w w w w w w w w w w w w w w w w w w G
 G w w w w w w w w w w w w w w w w w w w w w w w w w w w w G
